*********************************************************
*S         *            *           *      *****        *
****** *** **** ******* * ********* * ****     **** *** *
*      *   **** *                 *        ***        * *
* ****** *      ******************* *************** *** *
*      * * ******* *** *            *     *       *   * *
* **** * *       *     * ********** **G** ******* *** * *
* *    * ******* ***** * *          *   *             * *
* ** * *               * ************ *   ************* *
* *  * *****************          *   *****           * *
* ******    *      ************* ** *       ********* * *
*      * ** * ** * *          *   * *********   *   * * *
**** *****  * *  * ******** *******         * * * *   * *
* *      * ** * **          *     * * ***** * * * ***** *
*   * ** *    *  * *******    *** * *  *    * * * *     *
***** ********** * *    ******* * * ********* ***** *****
*     *   *        ****     * *   *               *     *
* * *** * **********    * *   * **************** **** ***
* * * * *        *   **** ***** *        *     * *  *   *
* *   * * ****** * * *  *       * * **** * *** * * **** *
* ***** * *      * * ** ***** *** ***  * *   * * *   ** *
*       *** ** *   *                *    * * *     *    *
*********************************************************
